ChinaCDC1_Primer_F	CCCTGTGGGTTTTACACTTAA
ChinaCDC1_Primer_R	ACGATTGTGCATCAGCTGA
ChinaCDC1_Probe_F	CCGTCTGCGGTATGTGGAAAGGTTATGG
ChinaCDC2_Primer_F	GGGGAACTTCTCCTGCTAGAAT
ChinaCDC2_Primer_R	CAGACATTTTGCTCTCAAGCTG
ChinaCDC2_Probe_F	TTGCTGCTGCTTGACAGATT
Corman1_Primer_F	GTGARATGGTCATGTGTGGCGG
Corman1_Primer_R	CARATGTTAAASACACTATTAGCATA
Corman1_Probe_F	CAGGTGGAACCTCATCAGGAGATGC
HKU1_Primer_F	TGGGGYTTTACRGGTAACCT
HKU1_Primer_R	AACRCGCTTAACAAAGCACTC
HKU1_Probe_F	TAGTTGTGATGCWATCATGACTAG
HKU2_Primer_F	TAATCAGACAAGGAACTGATTA
HKU2_Primer_R	CGAAGGTGTGACTTCCATG
HKU2_Probe_F	GCAAATTGTGCAATTTGCGG
Thailand1_Primer_F	CGTTTGGTGGACCCTCAGAT
Thailand1_Primer_R	CCCCACTGCGTTCTCCATT
Thailand1_Probe_F	CAACTGGCAGTAACCA
Japan1_Primer_F	AAATTTTGGGGACCAGGAAC
Japan1_Primer_R	TGGCAGCTGTGTAGGTCAAC
Japan1_Probe_F	ATGTCGCGCATTGGCATGGA
USCDC1_Primer_F	GACCCCAAAATCAGCGAAAT
USCDC1_Primer_R	TCTGGTTACTGCCAGTTGAATCTG
USCDC1_Probe_F	ACCCCGCATTACGTTTGGTGGACC
USCDC2_Primer_F	TTACAAACATTGGCCGCAAA
USCDC2_Primer_R	GCGCGACATTCCGAAGAA
USCDC2_Probe_F	ACAATTTGCCCCCAGCGCTTCAG
USCDC3_Primer_F	GGGAGCCTTGAATACACCAAAA
USCDC3_Primer_R	TGTAGCACGATTGCAGCATTG
USCDC3_Probe_F	AYCACATTGGCACCCGCAATCCTG
France1_Primer_F	ATGAGCTTAGTCCTGTTG
France1_Primer_R	CTCCCTTTGTTGTGTTGT
France1_Probe_F	AGATGTCTTGTGCTGCCGGTA
France2_Primer_F	GGTAACTGGTATGATTTCG
France2_Primer_R	CTGGTCAAGGTTAATATAGG
France2_Probe_F	TCATACAAACCACGCCAGG
Japan2_Primer_F	TTCGGATGCTCGAACTGCACC
Japan2_Primer_R	CTTTACCAGCACGTGCTAGAAGG
Japan2_Probe_F	ACCTCATGGTCATGTTATGG
Japan3_Primer_F	CTCGAACTGCACCTCATGG
Japan3_Primer_R	CAGAAGTTGTTATCGACATAGC
Japan3_Probe_R	GACATAGCGAGTGTATGCC
Japan4_Primer_F	TTGGCAAAATTCAAGACTCACTTT
Japan4_Primer_R	TGTGGTTCATAAAAATTCCTTTGTG
Japan4_Probe_F	AAGACTCACTTTCTTCCACAG
Japan5_Primer_F	TCAAGACTCACTTTCTTCCAC
Japan5_Primer_R	ATTTGAAACAAAGACACCTTCAC
Japan5_Probe_R	CAAAGACACCTTCACGAGG
Corman2_Primer_F	GTGARATGGTCATGTGTGGCGG
Corman2_Primer_R	CARATGTTAAASACACTATTAGCATA
Corman2_Probe_F	CAGGTGGAACCTCATCAGGAGATGC
France3_Primer_F	ACAGGTACGTTAATAGTTAATAGCGT
France3_Primer_R	ATATTGCAGCAGTACGCACACA
France3_Probe_F	ACACTAGCCATCCTTACTGCGCTTCG
